111111111111111
1C1C1ECC1100011
1C1C111C1011101
1CCCPCCC1011101
111C1C111011101
111C1CCC1100011
111111111111111