
NO sprites/1.xpm
SO sprites/2.xpm
WE sprites/4.xpm
C 225,200,10
EA sprites/3.xpm
F 200,30,0



1111111111111111111111
1000000000000000000001
1000000000000000010001
1000000000000000000001
1000000000000000000001
1000100000000000000001
1000000000000000000001
1000000000000000100001
1000000000000000000001
100000000N000000000001
1000011111111110000001
100001        10000001
100001        10000001
100001        10000001
100001        10000001
1000011111111110000001
1000000000000000000001
1000000000010000000001
1111111111111111111111
     