
NO sprites/1.xpm
SO sprites/2.xpm
WE sprites/4.xpm
C 225,200,10
EA sprites/3.xpm
F 200,30,0



        11111
       1100011
       11W0011
       1000001
       1000001
       1000001
       1000001
       1011001
      110111011
   1111001 101111
  11100001 1011111
  11000011 11000011
   111111   111111
     